%%%%%%%%%%%%%%%%%%%%
%.. P ...   ....   %
%..  .. .....  ... %
%..   ...   ....   %
%..  .. .....  ... %
%..   ...   ....  o%
%%%%%%%%%%%%%%%%%%%%
