%%%%%%%
% P   %
% %%% %
% %.  %
% %%% %
%.   G%
%%%%%%%
